111111
1E0111
1C0111
1P1111
111111
