1111111111111
1000000000001
1000000000001
1000000000001
1000E00000001
10C0000C00001
1000000000001
1P00000000001
1111111111111
